2 9 9 9 9 9 9 9 9 9 9 9 9 9 9 9 9 9 9 3
6 1 1 1 1 1 1 1 1 1 1 1 1 1 1 1 1 1 1 7
6 1 1 1 1 1 15 1 1 1 1 1 1 1 1 1 1 1 1 7
6 1 16 1 1 1 1 1 1 1 1 1 15 1 1 1 1 1 1 7
4 8 8 11 1 1 1 1 1 1 1 1 1 1 1 1 1 1 1 7
6 1 1 1 1 1 1 1 14 1 1 1 1 1 1 1 1 17 1 7
6 1 1 1 1 1 10 8 8 8 8 11 1 1 1 10 8 8 8 5
6 1 1 1 1 1 12 9 9 9 9 13 1 1 1 7 0 0 0 0
6 1 14 1 1 1 1 1 1 1 1 1 1 1 1 12 9 9 9 3
4 8 8 11 1 1 1 1 1 1 1 1 1 1 1 1 1 1 1 7
0 0 0 6 1 1 1 1 1 1 1 1 1 1 14 1 1 1 1 7
0 0 0 4 8 8 8 8 8 8 8 8 8 8 8 8 8 8 8 5